# list of object assets to load in this scene
[ASSETS]
mario.txt
block.txt
plain.txt
tunnel.txt
hud.txt
background1_4.txt
bros.txt
effect.txt

# Background: First line as x, y, w, h, base_id. Next y lines, each have y number as asset of each type
[BACKGROUND]
100	8	9	32	16	200000
0	1	1	1	1	1	1	1	1	1	1	1	1	5	24	24	24	24	24	24	24	24	24	24	24	24	24	24	24	24	24	24	24	
1	1	1	1	1	1	1	1	1	1	1	1	1	5	24	24	24	24	24	24	24	24	24	24	24	24	24	24	24	24	24	24	24	
2	1	1	1	1	1	1	1	1	1	1	1	1	5	24	24	24	24	24	24	24	24	24	24	24	24	24	24	24	24	24	24	24	
3	1	1	1	1	1	1	1	1	1	1	1	1	5	24	24	24	24	24	24	24	24	24	24	24	24	24	24	24	24	24	24	24	
4	1	1	1	1	1	1	1	1	1	1	1	1	5	24	24	24	24	24	24	24	24	24	24	24	24	24	24	24	24	24	24	24	
5	1	1	1	1	1	1	1	1	1	1	1	1	5	24	24	24	24	24	24	24	24	24	24	24	24	24	24	24	24	24	24	24	
6	1	1	1	1	1	1	1	1	1	1	1	1	5	24	24	24	24	24	24	24	24	24	24	24	24	24	24	24	24	24	24	24	
7	1	1	1	16	17	18	1	1	1	1	1	1	5	24	24	24	24	24	24	24	24	24	24	24	24	24	24	24	24	24	24	24	
8	1	1	1	21	22	23	1	1	1	1	1	1	5	24	24	24	24	24	24	24	24	24	24	24	24	24	24	24	24	24	24	24	
9	1	1	1	1	1	1	1	1	1	1	1	1	5	24	24	24	24	24	6	7	24	24	24	24	24	24	24	24	24	24	24	24	
10	1	1	1	1	1	1	1	1	1	1	1	1	5	24	24	24	24	24	11	12	24	24	24	24	24	24	24	24	24	24	24	24	
11	1	1	1	1	1	1	1	1	1	1	1	1	5	24	24	24	24	24	11	6	7	24	24	24	24	24	24	24	24	24	24	24	
12	1	1	1	1	8	9	1	1	1	1	1	1	5	24	24	24	24	24	11	24	12	24	24	24	24	24	24	24	24	6	7	24	
13	1	1	1	1	13	10	9	1	1	1	1	1	5	24	24	24	24	24	11	24	6	7	24	24	24	24	24	24	24	11	12	24	
14	1	19	19	8	20	14	15	1	1	1	1	1	5	24	24	24	24	6	7	24	24	12	24	24	24	24	24	24	6	7	12	24	
15	24	24	24	24	24	24	24	24	24	24	24	24	24	24	24	24	24	24	24	24	24	24	24	24	24	24	24	24	24	24	24	24

#
[OBJECTS]
# type	x	y	extra_settings per object type
# type: 0 = Mario , 10 = Coin, 2 = Goomba, 3 = Paragoomba
# See OBJECT_TYPE constants in AssetIDs.h

#Limit
1	512	304

#Platform
37	0	0	15	16	36	-1
37	512	0	15	16	36	1

# Platform
32	8	248	16	16	32	92101	92102	92103

# BOOMERANG_BRO
11	230	100

# MARIO
0	144	228

# TUNNEL
31	144	216	32	16	2	91100	91200	91200
