# list of object assets to load in this scene
[ASSETS]
mario.txt
goomba.txt
koopa.txt
coin.txt
cloud.txt
block.txt
plain.txt
plant.txt
tunnel.txt
background1_1.txt
block.txt
mushroom.txt
leaf.txt

# Background: First line as x, y, w, h, base_id. Next y lines, each have y number as asset of each type
[BACKGROUND]
100	8	9	176	27	200000
0	1	1	1	1	1	1	1	1	1	1	1	1	1	1	1	1	1	1	1	1	1	1	1	1	1	1	1	1	1	1	1	1	1	1	1	1	1	1	1	1	1	1	1	1	1	1	1	1	1	1	1	1	1	1	1	1	1	1	1	1	1	1	1	1	1	1	1	1	1	1	1	1	1	1	1	1	1	1	1	1	1	1	1	1	1	1	1	1	1	1	1	1	1	1	1	1	1	1	1	1	1	1	1	1	1	1	1	1	1	1	1	1	1	1	1	1	1	1	1	1	1	1	1	1	1	1	1	1	1	1	1	1	1	1	1	1	1	1	1	1	1	1	1	1	1	1	1	1	1	2	1	1	1	2	1	5	24	24	24	24	24	24	24	24	24	24	24	24	24	24	24	24	24	24	24	24
1	1	1	1	1	1	1	1	1	1	1	1	1	1	1	1	1	1	1	1	1	1	1	1	1	1	1	1	1	1	1	1	1	1	1	1	1	1	1	1	1	1	1	4	1	1	1	1	2	1	1	4	1	1	1	1	1	1	1	1	1	1	1	1	1	1	1	1	1	1	1	1	1	1	1	1	1	1	1	1	1	1	1	1	1	1	1	1	1	1	1	1	1	1	1	1	1	1	1	1	1	1	1	1	1	1	1	1	1	1	1	1	1	1	1	1	1	1	1	1	1	3	1	4	1	1	1	1	1	1	1	1	1	1	1	1	1	1	1	1	1	1	1	1	1	1	1	1	1	1	1	1	1	1	1	1	5	24	24	24	24	24	24	24	24	24	24	24	24	24	24	24	24	24	24	24	24
2	1	1	1	1	1	1	1	2	1	1	1	1	1	1	1	1	3	1	1	1	1	2	1	1	1	1	1	1	1	1	1	1	1	1	1	1	1	1	1	1	1	1	1	1	1	1	1	1	1	1	1	1	3	1	1	1	1	1	1	1	1	1	1	1	1	1	1	1	1	1	1	1	1	1	1	1	1	1	1	1	1	1	1	1	1	2	1	1	1	1	1	1	1	1	1	1	1	1	1	1	1	2	1	1	1	1	1	1	1	1	1	1	1	1	1	1	1	1	1	1	1	1	1	1	1	1	1	1	1	1	1	1	1	1	1	1	1	1	1	1	1	1	1	1	1	1	1	1	1	1	1	1	1	1	1	5	24	24	24	24	24	24	24	24	24	24	24	24	24	24	24	24	24	24	24	24
3	1	1	1	1	1	1	1	1	1	1	1	1	1	1	1	1	1	1	1	1	1	1	1	1	1	1	1	1	1	1	1	1	1	1	1	1	1	2	4	1	1	1	1	1	1	1	1	2	1	1	1	1	1	1	1	1	1	1	1	1	1	1	1	1	1	1	1	1	1	1	1	1	1	1	1	1	1	1	1	2	1	1	1	1	1	1	1	1	1	1	1	1	1	1	1	1	1	1	1	1	1	1	1	1	1	1	1	1	1	1	1	1	1	1	1	1	1	1	1	1	1	1	1	1	1	1	1	1	1	1	1	1	1	1	1	1	1	1	1	1	1	1	1	1	1	1	1	1	1	1	1	1	1	1	1	5	24	24	24	24	24	24	24	24	24	24	24	24	24	24	24	24	24	24	24	24
4	1	1	1	1	1	1	1	1	1	1	1	1	1	1	4	1	3	1	1	1	1	1	1	2	1	1	1	1	1	1	1	1	1	1	1	1	1	1	1	1	1	1	1	1	1	1	1	1	1	1	1	1	1	1	1	1	1	1	1	1	3	1	1	1	1	1	1	1	1	1	1	1	1	1	1	1	1	1	1	1	1	1	1	1	1	1	1	1	1	1	1	1	1	1	4	1	1	1	1	1	1	1	1	1	1	2	1	1	3	1	1	1	1	1	1	1	1	1	1	1	1	1	1	1	1	1	1	1	1	1	1	1	1	1	1	1	1	1	1	1	1	1	1	1	1	1	1	1	1	1	1	1	1	1	1	5	24	24	24	24	24	24	24	24	24	24	24	24	24	24	24	24	24	24	24	24
5	1	1	1	1	1	1	1	1	1	1	1	1	1	1	1	1	1	1	4	2	1	1	1	1	1	1	1	1	1	1	1	1	1	1	1	1	1	1	1	1	1	1	1	1	1	1	1	1	1	1	1	1	1	1	1	1	1	1	1	1	1	1	1	1	1	1	1	1	1	1	1	1	1	1	1	1	1	1	1	1	1	1	1	1	1	1	1	1	1	1	1	1	1	2	1	1	1	1	1	1	1	1	1	1	1	1	1	1	1	1	1	1	1	1	1	1	3	1	1	1	1	1	1	1	1	1	1	1	1	1	1	1	1	1	1	1	1	1	1	2	1	1	1	1	1	1	1	1	1	1	1	1	1	1	1	5	24	24	24	24	24	24	24	24	24	24	24	24	24	24	24	24	24	24	24	24
6	1	1	1	1	1	1	1	1	1	1	1	1	1	1	1	1	1	1	1	1	1	1	1	1	1	1	1	1	1	1	1	1	1	1	1	1	1	1	1	1	1	1	1	1	1	1	1	1	1	1	1	1	1	1	1	1	1	1	1	1	1	1	1	1	1	1	1	1	1	1	1	1	1	1	1	1	1	1	1	1	1	1	1	1	1	1	1	1	1	1	1	2	1	1	4	1	1	1	1	1	1	1	1	1	1	1	1	1	1	1	1	1	1	1	1	1	1	1	1	1	1	1	1	1	1	1	1	1	1	1	1	1	1	1	1	1	1	1	1	1	1	1	1	1	1	1	1	1	1	1	1	1	1	1	1	5	24	24	24	24	24	24	24	24	24	24	24	24	24	24	24	24	24	24	24	24
7	1	1	1	1	1	1	1	1	1	1	1	1	1	1	1	1	1	1	1	1	1	1	1	1	1	1	1	1	1	1	1	1	1	1	1	1	1	1	1	1	1	1	1	1	1	1	1	1	1	1	1	1	1	1	1	1	1	1	1	1	1	1	1	1	1	1	1	1	1	2	1	1	1	1	1	1	1	1	1	1	1	1	1	1	1	1	1	1	1	1	1	1	1	1	1	1	1	1	1	1	1	1	1	1	1	1	1	1	1	1	1	1	1	1	1	1	1	1	1	1	1	1	1	1	1	1	1	1	1	1	1	1	3	1	1	1	1	1	1	1	1	1	1	1	1	1	1	1	1	1	1	1	1	1	1	5	24	24	24	24	24	24	24	24	24	24	24	24	24	24	24	24	24	24	24	24
8	1	1	1	1	1	1	1	1	1	1	1	1	1	1	1	1	1	1	1	1	1	1	1	1	1	1	1	1	1	1	1	1	1	1	1	1	1	1	1	1	1	1	1	1	1	1	1	1	1	1	1	1	1	1	1	1	1	1	1	1	1	1	1	1	1	1	1	1	1	1	1	1	1	1	4	1	3	1	1	1	1	1	1	1	1	1	1	1	1	1	1	1	1	1	1	1	1	1	1	1	1	1	1	1	1	1	1	1	1	1	1	1	1	1	1	1	1	1	1	1	1	1	1	1	1	1	1	1	1	1	1	1	1	1	1	1	1	1	1	1	1	1	1	1	1	1	1	1	1	1	1	1	1	1	1	5	24	24	24	24	24	24	24	24	24	24	24	24	24	24	24	24	24	24	24	24
9	1	1	1	1	1	1	1	1	1	1	1	1	1	1	1	1	1	1	1	1	1	1	1	1	1	1	1	1	1	1	1	1	1	1	1	1	1	1	1	1	1	1	1	1	1	1	1	1	1	1	1	1	1	1	1	1	1	1	1	1	1	1	1	1	1	1	1	1	1	1	1	1	1	1	1	1	1	1	1	1	1	1	1	1	1	1	1	2	1	1	1	1	1	1	1	1	1	1	1	1	1	1	1	1	1	1	1	1	1	1	1	1	1	1	1	1	1	1	1	1	3	1	1	1	1	1	1	1	1	1	1	1	1	1	1	1	1	1	1	1	1	1	1	1	1	1	1	1	1	1	1	2	1	1	1	5	24	24	24	24	24	24	24	24	24	24	24	24	24	24	24	24	24	24	24	24
10	1	1	1	1	1	1	1	1	1	1	1	1	1	1	1	1	1	1	1	1	1	1	1	1	1	1	1	1	1	1	1	1	1	1	1	1	1	1	1	1	1	1	1	1	1	1	1	1	1	1	1	1	1	1	1	1	1	1	1	1	1	1	1	1	1	1	1	1	1	1	1	1	1	1	1	1	1	1	1	1	1	1	1	1	1	1	1	1	1	1	1	1	1	1	1	1	1	1	1	1	1	1	1	1	1	1	1	1	1	1	1	1	1	1	1	1	1	1	1	1	1	1	1	1	1	1	1	1	1	1	1	1	1	1	1	1	1	1	1	1	1	1	1	1	1	1	1	1	1	1	1	1	1	1	1	5	24	24	24	24	24	24	24	24	24	24	24	24	24	24	24	24	24	24	24	24
11	1	1	1	1	1	1	1	1	1	1	1	1	1	1	1	1	1	1	1	1	1	1	1	1	1	1	1	1	1	1	1	1	1	1	1	1	1	1	1	1	1	1	1	1	1	1	1	1	1	1	1	1	1	1	1	1	1	1	1	1	1	1	1	1	1	1	1	1	1	1	1	1	1	1	1	1	1	1	1	1	1	1	1	1	1	1	1	1	1	1	1	1	1	1	1	1	1	1	1	1	1	1	1	1	1	1	1	1	1	1	1	1	1	1	1	1	1	1	1	1	1	1	1	1	1	1	1	1	1	1	1	1	1	1	1	1	1	1	1	1	1	1	1	1	1	1	1	1	1	1	1	1	1	1	1	5	24	24	24	24	24	24	24	24	24	24	24	24	24	24	24	24	24	24	24	24
12	1	1	1	1	1	1	1	1	1	1	1	1	1	1	1	1	1	1	1	1	1	1	1	1	1	1	1	1	1	1	1	1	1	1	1	1	1	1	1	1	1	1	1	1	1	1	1	1	1	1	1	1	1	1	1	1	1	1	1	1	1	1	1	1	1	1	1	1	1	1	1	1	1	1	1	1	1	1	1	1	1	1	1	1	1	1	1	1	1	1	1	1	1	1	1	1	1	1	1	1	1	1	1	1	1	1	1	1	1	1	1	1	1	1	1	1	1	1	1	1	1	1	1	1	1	1	1	1	1	1	1	1	1	1	1	1	1	1	1	1	1	1	1	1	1	1	1	1	1	1	1	1	1	1	1	5	24	24	24	24	24	24	24	24	24	24	24	24	24	24	24	24	24	24	24	24
13	1	1	1	1	1	1	1	1	1	1	1	1	1	1	1	1	1	1	1	1	1	1	1	1	1	1	1	1	1	1	1	1	1	1	1	1	1	1	1	1	1	1	1	1	1	1	1	1	1	1	1	1	1	1	1	1	1	1	1	1	1	1	1	1	1	1	1	1	1	1	1	1	1	1	1	1	1	1	1	1	1	1	1	1	1	1	1	1	1	1	1	1	1	1	1	1	1	1	1	1	1	1	1	1	1	1	1	1	1	1	1	1	1	1	1	1	1	1	1	1	1	1	1	1	1	1	1	1	1	1	1	1	1	1	1	1	1	1	1	1	1	1	1	1	1	1	1	1	1	1	1	1	1	1	1	5	24	24	24	24	24	24	24	24	24	24	24	24	24	24	24	24	24	24	24	24
14	1	1	1	1	1	1	1	1	1	1	1	1	1	1	1	1	1	1	1	1	1	1	1	1	1	1	1	1	1	1	1	1	1	1	1	1	1	1	1	1	1	1	1	1	1	1	1	1	1	1	1	1	1	1	1	1	1	1	1	1	1	1	1	1	1	1	1	1	1	1	1	1	1	1	1	1	1	1	1	1	1	1	1	1	1	1	1	1	1	1	1	1	1	1	1	1	1	1	1	1	1	1	1	1	1	1	1	1	1	1	1	1	1	1	1	1	1	1	1	1	1	1	1	1	1	1	1	1	1	1	1	1	1	1	1	1	1	1	1	1	1	1	1	1	1	1	1	1	1	1	1	1	1	1	1	5	24	24	24	24	24	24	24	24	24	24	24	24	24	24	24	24	24	24	24	24
15	1	1	1	1	1	1	1	1	1	1	1	1	1	1	1	1	1	1	1	1	1	1	1	1	1	1	1	1	1	1	1	1	1	1	1	1	1	1	1	1	1	1	1	1	1	1	1	1	1	1	1	1	1	1	1	1	1	1	1	1	1	1	1	1	1	1	1	1	1	1	1	1	1	1	1	1	1	1	1	1	1	1	1	1	1	1	1	1	1	1	1	1	1	1	1	1	1	1	1	1	1	1	1	1	1	1	1	1	1	1	1	1	1	1	1	1	1	1	1	1	1	1	1	1	1	1	1	1	1	1	1	1	1	1	1	1	1	1	1	1	1	1	1	1	1	1	1	1	1	1	1	1	1	1	1	5	24	24	24	24	24	24	24	24	24	24	24	24	24	24	24	24	24	24	24	24
16	1	1	1	1	1	1	1	1	1	1	1	1	1	1	1	1	1	1	1	1	16	17	18	1	1	1	1	1	1	1	1	1	1	1	1	1	1	1	1	1	1	1	1	1	1	1	1	1	1	1	1	1	1	1	1	1	1	1	1	1	1	1	1	1	1	1	1	1	1	1	1	1	1	1	1	1	1	1	1	1	1	1	1	1	1	1	1	1	1	1	1	1	1	1	1	1	1	1	1	1	1	1	1	1	1	1	1	1	1	1	1	1	1	1	1	1	1	1	1	1	1	1	1	1	1	1	1	1	1	1	1	1	1	1	1	1	1	1	1	1	1	1	1	1	1	1	1	1	1	1	1	1	1	1	1	5	24	24	24	24	24	24	24	24	24	24	24	24	24	24	24	24	24	24	24	24
17	1	1	1	1	1	1	1	16	17	17	18	1	1	1	1	1	1	1	1	1	21	22	23	1	1	1	1	1	1	1	1	1	1	1	1	1	1	1	1	1	16	17	18	1	1	1	1	1	1	1	1	1	1	1	1	1	1	1	1	1	1	1	1	1	1	1	1	1	1	1	1	1	1	16	17	18	1	1	1	1	1	1	1	1	1	1	1	1	1	1	1	1	1	1	1	1	1	1	1	1	1	1	1	16	17	17	17	18	1	1	1	1	1	1	1	1	1	1	1	1	1	1	1	1	1	1	1	1	1	1	1	1	1	1	1	1	1	1	1	1	1	1	1	1	1	1	1	1	1	1	1	1	1	1	1	5	24	24	24	24	24	24	24	24	24	24	24	24	24	24	24	24	24	24	24	24
18	1	1	1	1	1	1	1	21	22	22	23	1	1	1	1	1	1	1	1	1	1	1	1	1	1	1	1	1	1	1	1	1	1	1	1	1	1	1	1	1	21	22	23	1	1	1	1	1	1	1	1	1	1	1	1	1	1	1	1	1	1	1	1	1	1	1	1	1	1	1	1	1	1	21	22	23	1	1	1	1	1	1	1	1	1	1	1	1	1	1	1	1	1	1	1	1	1	1	1	1	1	1	1	21	22	22	22	23	1	1	1	1	1	1	1	1	1	1	1	1	1	1	1	1	1	1	1	1	1	1	1	1	1	1	1	1	1	1	1	1	1	1	1	1	1	16	17	18	1	1	8	9	1	1	1	5	24	24	24	24	24	24	24	24	24	24	24	24	24	24	24	24	24	24	24	24
19	1	1	1	1	1	1	1	1	1	1	1	1	1	1	1	1	1	1	1	1	1	1	1	1	1	1	1	1	1	1	1	1	1	1	1	1	1	1	1	1	1	1	1	1	1	16	17	17	17	18	1	1	1	1	1	1	1	1	1	1	1	1	1	1	1	1	1	1	1	1	1	1	1	1	1	1	1	1	1	1	1	1	1	1	1	1	1	1	1	1	1	1	1	1	1	1	1	1	1	1	1	1	1	1	1	1	1	1	1	1	1	1	1	1	1	1	1	1	1	1	1	1	1	1	1	1	1	1	1	1	1	1	1	1	1	1	1	1	1	1	1	1	1	1	1	21	22	23	1	1	13	10	9	1	1	5	24	24	24	24	24	24	24	24	24	24	24	24	24	24	24	24	24	24	24	24
20	1	1	1	1	1	1	1	1	1	1	1	1	1	1	1	1	1	1	1	1	1	1	1	1	1	1	1	1	1	1	1	1	1	1	1	1	1	1	1	1	1	1	1	1	1	21	22	22	22	23	1	1	1	1	1	1	1	1	1	1	1	1	1	1	1	1	1	1	1	1	1	1	1	1	1	1	1	1	1	1	1	1	1	1	1	1	1	1	1	1	1	1	1	1	1	1	1	1	1	1	1	1	1	1	1	1	1	1	1	1	1	1	1	1	1	1	1	1	1	1	1	1	1	1	1	1	1	1	1	1	1	1	1	1	1	1	1	1	1	1	1	1	1	1	1	1	1	1	1	1	13	14	15	1	1	5	24	24	24	24	24	24	6	7	24	24	24	24	24	24	24	24	24	24	24	24
21	1	1	1	1	1	1	1	1	1	1	1	1	1	1	1	1	1	1	1	1	1	1	1	1	1	1	1	1	1	1	1	1	1	1	1	1	1	1	1	1	1	1	1	1	1	1	1	1	1	1	1	1	1	1	1	8	9	1	1	1	1	1	1	1	1	1	1	1	1	1	1	1	1	1	1	1	1	1	1	1	1	1	1	1	1	1	1	1	1	1	1	1	1	1	1	1	1	1	1	1	1	1	1	1	1	1	1	1	1	1	1	1	1	1	1	1	1	1	1	1	1	1	1	1	1	1	1	1	1	1	1	1	1	1	1	1	1	1	1	1	1	1	1	1	1	1	1	1	1	8	20	14	15	1	1	5	24	24	24	24	24	24	11	12	24	24	24	24	24	24	24	24	24	24	24	24
22	1	1	8	9	1	1	1	1	1	1	1	1	1	1	1	1	1	1	1	1	1	1	1	1	1	1	1	1	1	1	1	1	1	1	1	1	1	1	1	1	1	1	1	1	1	1	1	1	1	1	1	1	8	9	8	20	15	8	9	1	8	9	1	1	1	1	1	1	1	1	1	1	1	1	1	1	1	1	1	1	1	1	1	1	1	1	1	1	1	1	1	1	1	1	1	1	1	1	1	1	1	1	1	1	1	1	1	1	1	1	1	1	1	1	1	1	1	1	1	1	1	1	1	1	1	1	1	1	1	1	1	1	1	1	1	1	1	1	1	1	1	1	1	1	1	1	1	1	8	20	14	14	15	1	1	5	24	24	24	24	24	24	11	6	7	24	24	24	24	24	24	24	24	24	24	24
23	1	8	20	15	8	9	8	9	1	1	1	1	1	1	1	1	1	1	1	1	1	1	1	1	1	1	1	1	1	1	1	1	1	1	1	1	1	1	1	1	1	1	1	1	1	1	1	1	1	1	1	1	13	10	20	10	20	14	15	1	13	10	9	1	1	1	1	1	1	1	1	1	1	1	1	1	1	1	1	1	1	1	1	1	1	1	1	1	1	1	1	1	1	1	1	1	1	1	1	1	1	1	1	1	1	1	1	1	1	1	1	1	1	1	1	1	1	1	1	8	9	1	1	1	1	1	1	1	1	1	1	1	1	1	1	1	1	1	1	1	1	1	1	1	1	1	1	1	13	14	14	14	15	1	1	5	24	24	24	24	24	24	11	24	12	24	24	24	24	24	24	24	24	6	7	24
24	1	13	10	20	14	15	13	10	9	1	1	1	1	1	1	1	1	1	1	1	1	1	1	1	1	1	1	1	1	1	1	1	1	1	1	1	1	1	1	1	1	1	19	19	19	19	19	19	1	1	1	8	20	14	14	14	14	14	15	8	20	14	15	1	1	19	19	1	1	1	1	1	1	1	1	1	1	1	1	1	1	1	1	1	1	1	1	1	1	1	1	1	1	1	1	1	1	1	1	1	1	1	1	1	1	1	1	1	1	1	1	1	1	1	1	1	1	1	1	13	10	9	1	1	1	1	1	1	1	1	1	1	1	1	1	1	1	1	1	1	1	1	1	1	1	1	1	1	13	14	14	14	10	9	1	5	24	24	24	24	24	24	11	24	6	7	24	24	24	24	24	24	24	11	12	24
25	1	13	14	14	14	10	20	14	15	1	19	19	19	1	1	1	1	1	1	1	1	1	1	1	1	1	1	1	1	1	1	1	1	1	1	1	1	1	1	1	1	1	1	1	1	1	1	1	1	1	1	13	14	14	14	14	14	14	15	13	14	14	15	1	1	1	1	1	1	1	1	1	1	1	19	19	19	1	1	1	1	1	1	1	1	1	1	1	1	1	1	1	1	1	1	1	1	1	1	1	1	1	1	1	1	1	1	1	19	19	19	1	1	1	1	1	1	1	8	20	14	15	1	1	1	1	1	1	1	1	1	1	1	1	1	1	1	1	1	1	1	1	1	1	1	1	1	1	13	14	14	14	14	15	1	5	24	24	24	24	24	6	7	24	24	12	24	24	24	24	24	24	6	7	12	24
26	1	13	14	14	14	14	14	14	15	1	1	1	1	1	1	1	1	1	1	1	1	1	1	1	1	1	1	1	1	1	1	1	1	1	1	1	1	1	1	1	1	1	1	1	1	1	1	1	1	1	1	13	14	14	14	14	14	14	15	13	14	14	15	1	1	1	1	1	1	1	1	1	1	1	1	1	1	1	1	1	1	1	1	1	1	1	1	1	1	1	1	1	1	1	1	1	1	1	1	1	1	1	1	1	1	1	1	1	1	1	1	1	1	1	1	1	1	1	13	14	14	15	1	1	1	1	1	1	1	1	1	1	1	1	1	1	1	1	1	1	1	1	1	1	1	1	1	1	13	14	14	14	14	15	1	5	24	24	24	24	24	11	24	24	24	12	24	24	24	24	24	24	11	24	12	24

#
[OBJECTS]
# type	x	y	extra_settings per object type
# type: 0 = Mario , 10 = Coin, 2 = Goomba, 3 = Paragoomba
# See OBJECT_TYPE constants in AssetIDs.h

#Limit
1	2816	480

#Portal 
50	90	345	120	369	4	2336	300
50	2696	345	2720	369	5

# Semi solid 1 (blue, pink)
36	326	345	15	16	5	93501	93502	93502
30	281	345	15	16	3	93401	93402	93403
35	281	361	15	16	3	93404	93405	93406
35	281	377	15	16	3	93404	93405	93406
35	281	393	15	16	3	93404	93405	93406
35	281	409	15	16	3	93407	93408	93409

36	293	377	15	16	3	93501	93502	93502
30	249	377	15	16	3	93301	93302	93303
35	249	393	15	16	3	93304	93305	93306
35	249	409	15	16	3	93307	93308	93309

# Semi solid 2 (white, pink, green, green)
36	580	314	15	16	5	93501	93502	93502
30	521	314	15	16	4	93101	93102	93103
35	521	330	15	16	4	93104	93105	93106
35	521	346	15	16	4	93104	93105	93106
35	521	362	15	16	4	93104	93105	93106
35	521	378	15	16	4	93104	93105	93106

36	535	345	15	16	5	93501	93502	93502
30	476	345	15	16	4	93301	93302	93303
35	476	361	15	16	4	93304	93305	93306
35	476	377	15	16	4	93304	93305	93306
35	476	393	15	16	4	93304	93305	93306
35	476	409	15	16	4	93307	93308	93309

36	490	377	15	16	3	93501	93502	93502
30	416	377	15	16	5	93201	93202	93203
35	416	393	15	16	5	93204	93205	93206
35	416	409	15	16	5	93207	93208	93209

36	551	393	15	16	2	93501	93502	93502
30	521	393	15	16	6	93201	93202	93203
35	521	409	15	16	6	93207	93208	93209

# Semi solid 3 (blue, pink, green)
36	1437	329	15	16	6	93501	93502	93502
30	1332	329	15	16	7	93401	93402	93403
35	1332	345	15	16	7	93404	93405	93406
35	1332	361	15	16	7	93404	93405	93406
35	1332	377	15	16	7	93404	93405	93406
35	1332	393	15	16	7	93404	93405	93406
35	1332	409	15	16	7	93407	93408	93409

36	1407	361	15	16	4	93501	93502	93502
30	1302	361	15	16	7	93301	93302	93303
35	1302	377	15	16	7	93304	93305	93306
35	1302	393	15	16	7	93304	93305	93306
35	1302	409	15	16	7	93307	93308	93309

36	1377	393	15	16	2	93501	93502	93502
30	1272	393	15	16	7	93201	93202	93203
35	1272	409	15	16	7	93207	93208	93209

# Semi solid 3 (green, pink)
36	2226	281	15	16	9	93501	93502	93502
30	2181	281	15	16	3	93201	93202	93203
35	2181	297	15	16	3	93204	93205	93206
35	2181	313	15	16	3	93204	93205	93206
35	2181	329	15	16	3	93204	93205	93206
35	2181	345	15	16	3	93204	93205	93206
35	2181	361	15	16	3	93204	93205	93206
35	2181	377	15	16	3	93204	93205	93206
35	2181	393	15	16	3	93204	93205	93206
35	2181	409	15	16	3	93207	93208	93209

36	2196	377	15	16	3	93501	93502	93502
30	2151	377	15	16	3	93301	93302	93303
35	2151	393	15	16	3	93304	93305	93306
35	2151	409	15	16	3	93307	93308	93309


# PLANT
34	376	377	32	16	3	91100	91200	91200	9
34	1807	393	32	16	2	91100	91200	91200	7
34	1871	377	32	16	3	91100	91200	91200	8

# TUNNEL
31	2336	393	32	16	2	91100	91200	91200

31	2272	393	32	16	2	91200	91200	91200
32	2263	377	16	16	2	80002	80002	80002

31	2272	121	32	16	12	91100	91200	91200
32	2263	313	16	16	2	80002	80002	80002

# Platform
32	8	424	16	16	39	92101	92102	92103
32	632	408	16	16	29	92101	92102	92103
32	632	424	16	16	29	92104	92105	92106

32	1160	424	16	16	22	92101	92102	92103
32	1544	424	16	16	5	92101	92102	92103
32	1672	424	16	16	36	92101	92102	92103
32	2264	424	16	16	35	92101	92102	92103

32	1511	345	16	16	2	80002	80002	80002

32	1575	409	16	16	3	80002	80002	80002
32	1591	393	16	16	2	80002	80002	80002
32	1607	377	16	16	1	80002	80002	80002

32	1671	409	16	16	3	80002	80002	80002
32	1671	393	16	16	2	80002	80002	80002
32	1671	377	16	16	1	80002	80002	80002

#QUESTION_BLOCK_COIN
61	184	361	0
61	200	361	0

61	232	313	0
61	432	329	0

61	712	361	0

#QUESTION_BLOCK_MUSHROOM_AND_LEAF
61	248	313	3
61	663	393	3
61	1479	377	3

# GOOMBA
2	248	400
2	535	400
2	840	384
2	888	384
3	952	384

# KOOPA
5	580	370
6	1332	305
6	1374	305
6	1416	305
4	1469	400

# MARIO
0	16	310

#Platform
37	0	0	16	16	36	-1	-1	-1
37	2816	0	16	16	36	-1	-1	-1

# COIN
20	1080	328
20	1110	296
20	1140	264
20	1170	232
20	1200	200

20	1328	88
20	1344	88
20	1360	88

20	1484	120
20	1468	120

20	1528	136
20	1544	136
20	1560	136
20	1576	136

20	1602	120
20	1618	120
20	1634	120
20	1650	120

20	1676	152
20	1708	120
20	1740	136
20	1804	104
20	1852	136

// Flying map
35	1312	184	15	16	5	93504	93505	93503
36	1372	152	15	16	3	93501	93502	93503
30	1312	152	15	16	4	93301	93302	93303
35	1312	168	15	16	4	93307	93308	93309

// Cloud
30	1404	200	15	16	4	90400	90400	90400 
30	1484	184	15	16	13	90400	90400	90400
